%%%%%%%
%   .P%
% %%% %
%  %  %
%%   %%
%. %%%%
%%%%%%%
